trial_number,genome,merit,accuracy,genome_length,door_rooms,exit_rooms,correct_doors,incorrect_doors,correct_exits,incorrect_exits,doors_taken_0,doors_correct_0,doors_taken_1,doors_correct_1,doors_taken_2,doors_correct_2,doors_taken_3,doors_correct_3,did_repro
0,"[99]xmRdcLPDpNHogQJMqRwtfoctApchoIpBxdNQmEopebveHcpLhNieQbnNIwNNKHOnocSdMpJymMNApRvRBaRsMGzQSwvHMNJtNdD",1.92794e+19,0.95,99,220,11,209,11,11,0,11,11,112,112,49,49,59,48,"True"
1,"[99]xmRdcLPDpNHogQJMqRwtfoctApchoIpBxdNQmEopebveHcpLhNieQbnNIwNNKHOnocSdMpJymMNApRvRBaRsMGzQSwvHMNJtNdD",5.1032e+21,0.951417,99,247,12,235,12,12,0,12,12,113,113,63,63,71,59,"True"
2,"[99]xmRdcLPDpNHogQJMqRwtfoctApchoIpBxdNQmEopebveHcpLhNieQbnNIwNNKHOnocSdMpJymMNApRvRBaRsMGzQSwvHMNJtNdD",4.12234e+24,0.96337,99,273,10,263,10,10,0,10,10,135,135,58,58,80,70,"True"
3,"[99]xmRdcLPDpNHogQJMqRwtfoctApchoIpBxdNQmEopebveHcpLhNieQbnNIwNNKHOnocSdMpJymMNApRvRBaRsMGzQSwvHMNJtNdD",1.35081e+24,0.952555,99,274,13,261,13,13,0,13,13,122,122,71,71,81,68,"True"
4,"[99]xmRdcLPDpNHogQJMqRwtfoctApchoIpBxdNQmEopebveHcpLhNieQbnNIwNNKHOnocSdMpJymMNApRvRBaRsMGzQSwvHMNJtNdD",6.31746e+18,0.961722,99,209,8,201,8,8,0,8,8,107,107,46,46,56,48,"True"
5,"[99]xmRdcLPDpNHogQJMqRwtfoctApchoIpBxdNQmEopebveHcpLhNieQbnNIwNNKHOnocSdMpJymMNApRvRBaRsMGzQSwvHMNJtNdD",9.19311e+19,0.963801,99,221,8,213,8,8,0,8,8,105,105,60,60,56,48,"True"
6,"[99]xmRdcLPDpNHogQJMqRwtfoctApchoIpBxdNQmEopebveHcpLhNieQbnNIwNNKHOnocSdMpJymMNApRvRBaRsMGzQSwvHMNJtNdD",1.08065e+24,0.949091,99,275,14,261,14,14,0,14,14,125,125,67,67,83,69,"True"
7,"[99]xmRdcLPDpNHogQJMqRwtfoctApchoIpBxdNQmEopebveHcpLhNieQbnNIwNNKHOnocSdMpJymMNApRvRBaRsMGzQSwvHMNJtNdD",2.24441e+20,0.964444,99,225,8,217,8,8,0,8,8,120,120,54,54,51,43,"True"
8,"[99]xmRdcLPDpNHogQJMqRwtfoctApchoIpBxdNQmEopebveHcpLhNieQbnNIwNNKHOnocSdMpJymMNApRvRBaRsMGzQSwvHMNJtNdD",9.87103e+18,0.966507,99,209,7,202,7,7,0,7,7,107,107,51,51,51,44,"True"
9,"[99]xmRdcLPDpNHogQJMqRwtfoctApchoIpBxdNQmEopebveHcpLhNieQbnNIwNNKHOnocSdMpJymMNApRvRBaRsMGzQSwvHMNJtNdD",4.75273e+22,0.964143,99,251,9,242,9,9,0,9,9,126,126,65,65,60,51,"True"
10,"[99]xmRdcLPDpNHogQJMqRwtfoctApchoIpBxdNQmEopebveHcpLhNieQbnNIwNNKHOnocSdMpJymMNApRvRBaRsMGzQSwvHMNJtNdD",1.43642e+20,0.972603,99,219,6,213,6,6,0,6,6,114,114,46,46,59,53,"True"
11,"[99]xmRdcLPDpNHogQJMqRwtfoctApchoIpBxdNQmEopebveHcpLhNieQbnNIwNNKHOnocSdMpJymMNApRvRBaRsMGzQSwvHMNJtNdD",1.92794e+19,0.95,99,220,11,209,11,11,0,11,11,100,100,66,66,54,43,"True"
12,"[99]xmRdcLPDpNHogQJMqRwtfoctApchoIpBxdNQmEopebveHcpLhNieQbnNIwNNKHOnocSdMpJymMNApRvRBaRsMGzQSwvHMNJtNdD",4.46944e+26,0.956667,99,300,12,287,13,12,0,12,12,129,129,67,67,104,91,"False"
13,"[99]xmRdcLPDpNHogQJMqRwtfoctApchoIpBxdNQmEopebveHcpLhNieQbnNIwNNKHOnocSdMpJymMNApRvRBaRsMGzQSwvHMNJtNdD",8.56176e+20,0.973568,99,227,6,221,6,6,0,6,6,106,106,55,55,66,60,"True"
14,"[99]xmRdcLPDpNHogQJMqRwtfoctApchoIpBxdNQmEopebveHcpLhNieQbnNIwNNKHOnocSdMpJymMNApRvRBaRsMGzQSwvHMNJtNdD",1.2459e+22,0.955823,99,249,11,238,11,11,0,11,11,119,119,61,61,69,58,"True"
15,"[99]xmRdcLPDpNHogQJMqRwtfoctApchoIpBxdNQmEopebveHcpLhNieQbnNIwNNKHOnocSdMpJymMNApRvRBaRsMGzQSwvHMNJtNdD",1.92794e+19,0.980583,99,206,4,202,4,4,0,4,4,108,108,43,43,55,51,"True"
16,"[99]xmRdcLPDpNHogQJMqRwtfoctApchoIpBxdNQmEopebveHcpLhNieQbnNIwNNKHOnocSdMpJymMNApRvRBaRsMGzQSwvHMNJtNdD",2.09027e+21,0.958159,99,239,10,229,10,10,0,10,10,121,121,56,56,62,52,"True"
17,"[99]xmRdcLPDpNHogQJMqRwtfoctApchoIpBxdNQmEopebveHcpLhNieQbnNIwNNKHOnocSdMpJymMNApRvRBaRsMGzQSwvHMNJtNdD",3.0124e+19,0.971698,99,212,6,206,6,6,0,6,6,107,107,45,45,60,54,"True"
18,"[99]xmRdcLPDpNHogQJMqRwtfoctApchoIpBxdNQmEopebveHcpLhNieQbnNIwNNKHOnocSdMpJymMNApRvRBaRsMGzQSwvHMNJtNdD",8.56176e+20,0.969432,99,229,7,222,7,7,0,7,7,108,108,61,61,60,53,"True"
19,"[99]xmRdcLPDpNHogQJMqRwtfoctApchoIpBxdNQmEopebveHcpLhNieQbnNIwNNKHOnocSdMpJymMNApRvRBaRsMGzQSwvHMNJtNdD",1.33777e+21,0.965665,99,233,8,225,8,8,0,8,8,122,122,53,53,58,50,"True"
20,"[99]xmRdcLPDpNHogQJMqRwtfoctApchoIpBxdNQmEopebveHcpLhNieQbnNIwNNKHOnocSdMpJymMNApRvRBaRsMGzQSwvHMNJtNdD",1.81302e+23,0.968627,99,255,8,247,8,8,0,8,8,122,122,56,56,77,69,"True"
21,"[99]xmRdcLPDpNHogQJMqRwtfoctApchoIpBxdNQmEopebveHcpLhNieQbnNIwNNKHOnocSdMpJymMNApRvRBaRsMGzQSwvHMNJtNdD",2.83285e+23,0.951311,99,267,13,254,13,13,0,13,13,126,126,65,65,76,63,"True"
22,"[99]xmRdcLPDpNHogQJMqRwtfoctApchoIpBxdNQmEopebveHcpLhNieQbnNIwNNKHOnocSdMpJymMNApRvRBaRsMGzQSwvHMNJtNdD",4.75273e+22,0.964143,99,251,9,242,9,9,0,9,9,114,114,69,69,68,59,"True"
23,"[99]xmRdcLPDpNHogQJMqRwtfoctApchoIpBxdNQmEopebveHcpLhNieQbnNIwNNKHOnocSdMpJymMNApRvRBaRsMGzQSwvHMNJtNdD",2.40992e+19,0.971564,99,211,6,205,6,6,0,6,6,110,110,47,47,54,48,"True"
24,"[99]xmRdcLPDpNHogQJMqRwtfoctApchoIpBxdNQmEopebveHcpLhNieQbnNIwNNKHOnocSdMpJymMNApRvRBaRsMGzQSwvHMNJtNdD",1.68851e+24,0.95941,99,271,11,260,11,11,0,11,11,112,112,71,71,88,77,"True"
25,"[99]xmRdcLPDpNHogQJMqRwtfoctApchoIpBxdNQmEopebveHcpLhNieQbnNIwNNKHOnocSdMpJymMNApRvRBaRsMGzQSwvHMNJtNdD",5.5329e+23,0.955224,99,268,12,256,12,12,0,12,12,129,129,64,64,75,63,"True"
26,"[99]xmRdcLPDpNHogQJMqRwtfoctApchoIpBxdNQmEopebveHcpLhNieQbnNIwNNKHOnocSdMpJymMNApRvRBaRsMGzQSwvHMNJtNdD",3.80218e+22,0.960317,99,252,10,242,10,10,0,10,10,121,121,65,65,66,56,"True"
27,"[99]xmRdcLPDpNHogQJMqRwtfoctApchoIpBxdNQmEopebveHcpLhNieQbnNIwNNKHOnocSdMpJymMNApRvRBaRsMGzQSwvHMNJtNdD",4.79903e+25,0.952055,99,292,14,278,14,14,0,14,14,151,151,69,69,72,58,"False"
28,"[99]xmRdcLPDpNHogQJMqRwtfoctApchoIpBxdNQmEopebveHcpLhNieQbnNIwNNKHOnocSdMpJymMNApRvRBaRsMGzQSwvHMNJtNdD",4.08256e+21,0.958678,99,242,10,232,10,10,0,10,10,115,115,56,56,71,61,"True"
29,"[99]xmRdcLPDpNHogQJMqRwtfoctApchoIpBxdNQmEopebveHcpLhNieQbnNIwNNKHOnocSdMpJymMNApRvRBaRsMGzQSwvHMNJtNdD",8.72938e+26,0.96633,99,297,10,287,10,10,0,10,10,144,144,68,68,85,75,"False"
30,"[99]xmRdcLPDpNHogQJMqRwtfoctApchoIpBxdNQmEopebveHcpLhNieQbnNIwNNKHOnocSdMpJymMNApRvRBaRsMGzQSwvHMNJtNdD",3.50689e+20,0.95279,99,233,11,222,11,11,0,11,11,107,107,61,61,65,54,"True"
31,"[99]xmRdcLPDpNHogQJMqRwtfoctApchoIpBxdNQmEopebveHcpLhNieQbnNIwNNKHOnocSdMpJymMNApRvRBaRsMGzQSwvHMNJtNdD",1.23388e+19,0.953704,99,216,10,206,10,10,0,10,10,109,109,49,49,58,48,"True"
32,"[99]xmRdcLPDpNHogQJMqRwtfoctApchoIpBxdNQmEopebveHcpLhNieQbnNIwNNKHOnocSdMpJymMNApRvRBaRsMGzQSwvHMNJtNdD",2.09027e+21,0.950617,99,243,12,231,12,12,0,12,12,114,114,63,63,66,54,"True"
33,"[99]xmRdcLPDpNHogQJMqRwtfoctApchoIpBxdNQmEopebveHcpLhNieQbnNIwNNKHOnocSdMpJymMNApRvRBaRsMGzQSwvHMNJtNdD",5.15292e+24,0.950355,99,282,14,268,14,14,0,14,14,122,122,70,70,90,76,"True"
34,"[99]xmRdcLPDpNHogQJMqRwtfoctApchoIpBxdNQmEopebveHcpLhNieQbnNIwNNKHOnocSdMpJymMNApRvRBaRsMGzQSwvHMNJtNdD",1.55737e+22,0.963415,99,246,9,237,9,9,0,9,9,114,114,57,57,75,66,"True"
35,"[99]xmRdcLPDpNHogQJMqRwtfoctApchoIpBxdNQmEopebveHcpLhNieQbnNIwNNKHOnocSdMpJymMNApRvRBaRsMGzQSwvHMNJtNdD",1.67222e+21,0.946721,99,244,13,231,13,13,0,13,13,110,110,69,69,65,52,"True"
36,"[99]xmRdcLPDpNHogQJMqRwtfoctApchoIpBxdNQmEopebveHcpLhNieQbnNIwNNKHOnocSdMpJymMNApRvRBaRsMGzQSwvHMNJtNdD",2.4334e+22,0.945736,99,258,14,244,14,14,0,14,14,124,124,65,65,69,55,"True"
37,"[99]xmRdcLPDpNHogQJMqRwtfoctApchoIpBxdNQmEopebveHcpLhNieQbnNIwNNKHOnocSdMpJymMNApRvRBaRsMGzQSwvHMNJtNdD",1.81302e+23,0.954373,99,263,12,251,12,12,0,12,12,122,122,74,74,67,55,"True"
38,"[99]xmRdcLPDpNHogQJMqRwtfoctApchoIpBxdNQmEopebveHcpLhNieQbnNIwNNKHOnocSdMpJymMNApRvRBaRsMGzQSwvHMNJtNdD",1.54235e+19,0.95814,99,215,9,206,9,9,0,9,9,112,112,47,47,56,47,"True"
39,"[99]xmRdcLPDpNHogQJMqRwtfoctApchoIpBxdNQmEopebveHcpLhNieQbnNIwNNKHOnocSdMpJymMNApRvRBaRsMGzQSwvHMNJtNdD",5.5329e+23,0.958647,99,266,11,255,11,11,0,11,11,114,114,69,69,83,72,"True"
40,"[99]xmRdcLPDpNHogQJMqRwtfoctApchoIpBxdNQmEopebveHcpLhNieQbnNIwNNKHOnocSdMpJymMNApRvRBaRsMGzQSwvHMNJtNdD",1.07022e+21,0.965517,99,232,8,224,8,8,0,8,8,117,117,58,58,57,49,"True"
41,"[99]xmRdcLPDpNHogQJMqRwtfoctApchoIpBxdNQmEopebveHcpLhNieQbnNIwNNKHOnocSdMpJymMNApRvRBaRsMGzQSwvHMNJtNdD",1.45042e+23,0.954198,99,262,12,250,12,12,0,12,12,116,116,62,62,84,72,"True"
42,"[99]xmRdcLPDpNHogQJMqRwtfoctApchoIpBxdNQmEopebveHcpLhNieQbnNIwNNKHOnocSdMpJymMNApRvRBaRsMGzQSwvHMNJtNdD",3.04175e+22,0.949416,99,257,13,244,13,13,0,13,13,115,115,63,63,79,66,"True"
43,"[99]xmRdcLPDpNHogQJMqRwtfoctApchoIpBxdNQmEopebveHcpLhNieQbnNIwNNKHOnocSdMpJymMNApRvRBaRsMGzQSwvHMNJtNdD",1.79553e+20,0.981481,99,216,4,212,4,4,0,4,4,107,107,50,50,59,55,"True"
44,"[99]xmRdcLPDpNHogQJMqRwtfoctApchoIpBxdNQmEopebveHcpLhNieQbnNIwNNKHOnocSdMpJymMNApRvRBaRsMGzQSwvHMNJtNdD",1.54235e+19,0.953917,99,217,10,207,10,10,0,10,10,109,109,56,56,52,42,"True"
45,"[99]xmRdcLPDpNHogQJMqRwtfoctApchoIpBxdNQmEopebveHcpLhNieQbnNIwNNKHOnocSdMpJymMNApRvRBaRsMGzQSwvHMNJtNdD",2.09027e+21,0.958159,99,239,10,229,10,10,0,10,10,106,106,59,59,74,64,"True"
46,"[99]xmRdcLPDpNHogQJMqRwtfoctApchoIpBxdNQmEopebveHcpLhNieQbnNIwNNKHOnocSdMpJymMNApRvRBaRsMGzQSwvHMNJtNdD",3.50689e+20,0.948936,99,235,12,223,12,12,0,12,12,108,108,59,59,68,56,"True"
47,"[99]xmRdcLPDpNHogQJMqRwtfoctApchoIpBxdNQmEopebveHcpLhNieQbnNIwNNKHOnocSdMpJymMNApRvRBaRsMGzQSwvHMNJtNdD",3.26605e+21,0.978355,99,231,5,226,5,5,0,5,5,111,111,61,61,59,54,"True"
48,"[99]xmRdcLPDpNHogQJMqRwtfoctApchoIpBxdNQmEopebveHcpLhNieQbnNIwNNKHOnocSdMpJymMNApRvRBaRsMGzQSwvHMNJtNdD",6.44115e+24,0.97048,99,271,8,263,8,8,0,8,8,122,122,67,67,82,74,"True"
49,"[99]xmRdcLPDpNHogQJMqRwtfoctApchoIpBxdNQmEopebveHcpLhNieQbnNIwNNKHOnocSdMpJymMNApRvRBaRsMGzQSwvHMNJtNdD",1.05989e+18,0.974359,99,195,5,190,5,5,0,5,5,94,94,44,44,57,52,"True"
50,"[99]xmRdcLPDpNHogQJMqRwtfoctApchoIpBxdNQmEopebveHcpLhNieQbnNIwNNKHOnocSdMpJymMNApRvRBaRsMGzQSwvHMNJtNdD",4.34133e+17,0.964103,99,195,7,188,7,7,0,7,7,104,104,46,46,45,38,"True"
51,"[99]xmRdcLPDpNHogQJMqRwtfoctApchoIpBxdNQmEopebveHcpLhNieQbnNIwNNKHOnocSdMpJymMNApRvRBaRsMGzQSwvHMNJtNdD",6.44115e+24,0.947368,99,285,15,270,15,15,0,15,15,136,136,81,81,68,53,"False"
52,"[99]xmRdcLPDpNHogQJMqRwtfoctApchoIpBxdNQmEopebveHcpLhNieQbnNIwNNKHOnocSdMpJymMNApRvRBaRsMGzQSwvHMNJtNdD",6.44115e+24,0.97048,99,271,8,263,8,8,0,8,8,128,128,57,57,86,78,"True"
53,"[99]xmRdcLPDpNHogQJMqRwtfoctApchoIpBxdNQmEopebveHcpLhNieQbnNIwNNKHOnocSdMpJymMNApRvRBaRsMGzQSwvHMNJtNdD",4.70687e+19,0.963303,99,218,8,210,8,8,0,8,8,107,107,52,52,59,51,"True"
54,"[99]xmRdcLPDpNHogQJMqRwtfoctApchoIpBxdNQmEopebveHcpLhNieQbnNIwNNKHOnocSdMpJymMNApRvRBaRsMGzQSwvHMNJtNdD",2.80552e+20,0.9375,99,240,15,225,15,15,0,15,15,110,110,65,65,65,50,"True"
55,"[99]xmRdcLPDpNHogQJMqRwtfoctApchoIpBxdNQmEopebveHcpLhNieQbnNIwNNKHOnocSdMpJymMNApRvRBaRsMGzQSwvHMNJtNdD",4.34133e+17,0.973822,99,191,5,186,5,5,0,5,5,104,104,39,39,48,43,"True"
56,"[99]xmRdcLPDpNHogQJMqRwtfoctApchoIpBxdNQmEopebveHcpLhNieQbnNIwNNKHOnocSdMpJymMNApRvRBaRsMGzQSwvHMNJtNdD",9.28267e+22,0.960938,99,256,10,246,10,10,0,10,10,118,118,67,67,71,61,"True"
57,"[99]xmRdcLPDpNHogQJMqRwtfoctApchoIpBxdNQmEopebveHcpLhNieQbnNIwNNKHOnocSdMpJymMNApRvRBaRsMGzQSwvHMNJtNdD",1.17164e+26,0.971831,99,284,8,276,8,8,0,8,8,144,144,61,61,79,71,"True"
58,"[99]xmRdcLPDpNHogQJMqRwtfoctApchoIpBxdNQmEopebveHcpLhNieQbnNIwNNKHOnocSdMpJymMNApRvRBaRsMGzQSwvHMNJtNdD",5.94091e+22,0.964286,99,252,9,243,9,9,0,9,9,127,127,67,67,58,49,"True"
59,"[99]xmRdcLPDpNHogQJMqRwtfoctApchoIpBxdNQmEopebveHcpLhNieQbnNIwNNKHOnocSdMpJymMNApRvRBaRsMGzQSwvHMNJtNdD",8.56176e+20,0.931727,99,249,17,232,17,17,0,17,17,110,110,66,66,73,56,"True"
60,"[99]xmRdcLPDpNHogQJMqRwtfoctApchoIpBxdNQmEopebveHcpLhNieQbnNIwNNKHOnocSdMpJymMNApRvRBaRsMGzQSwvHMNJtNdD",3.7655e+19,0.971831,99,213,6,207,6,6,0,6,6,108,108,53,53,52,46,"True"
61,"[99]xmRdcLPDpNHogQJMqRwtfoctApchoIpBxdNQmEopebveHcpLhNieQbnNIwNNKHOnocSdMpJymMNApRvRBaRsMGzQSwvHMNJtNdD",1.43642e+20,0.948052,99,231,12,219,12,12,0,12,12,103,103,63,63,65,53,"True"
62,"[99]xmRdcLPDpNHogQJMqRwtfoctApchoIpBxdNQmEopebveHcpLhNieQbnNIwNNKHOnocSdMpJymMNApRvRBaRsMGzQSwvHMNJtNdD",5.42666e+17,0.964286,99,196,7,189,7,7,0,7,7,103,103,40,40,53,46,"True"
63,"[99]xmRdcLPDpNHogQJMqRwtfoctApchoIpBxdNQmEopebveHcpLhNieQbnNIwNNKHOnocSdMpJymMNApRvRBaRsMGzQSwvHMNJtNdD",8.56176e+20,0.961373,99,233,9,224,9,9,0,9,9,118,118,55,55,60,51,"True"
64,"[99]xmRdcLPDpNHogQJMqRwtfoctApchoIpBxdNQmEopebveHcpLhNieQbnNIwNNKHOnocSdMpJymMNApRvRBaRsMGzQSwvHMNJtNdD",9.87103e+18,0.966507,99,209,7,202,7,7,0,7,7,111,111,49,49,49,42,"True"
65,"[99]xmRdcLPDpNHogQJMqRwtfoctApchoIpBxdNQmEopebveHcpLhNieQbnNIwNNKHOnocSdMpJymMNApRvRBaRsMGzQSwvHMNJtNdD",5.5329e+23,0.958647,99,266,11,255,11,11,0,11,11,129,129,59,59,78,67,"True"
66,"[99]xmRdcLPDpNHogQJMqRwtfoctApchoIpBxdNQmEopebveHcpLhNieQbnNIwNNKHOnocSdMpJymMNApRvRBaRsMGzQSwvHMNJtNdD",2.98334e+16,0.951872,99,187,9,178,9,9,0,9,9,99,99,40,40,48,39,"True"
67,"[99]xmRdcLPDpNHogQJMqRwtfoctApchoIpBxdNQmEopebveHcpLhNieQbnNIwNNKHOnocSdMpJymMNApRvRBaRsMGzQSwvHMNJtNdD",1.07022e+21,0.942623,99,244,14,230,14,14,0,14,14,115,115,55,55,74,60,"True"
68,"[99]xmRdcLPDpNHogQJMqRwtfoctApchoIpBxdNQmEopebveHcpLhNieQbnNIwNNKHOnocSdMpJymMNApRvRBaRsMGzQSwvHMNJtNdD",8.72938e+26,0.972696,99,293,8,285,8,8,0,8,8,146,146,59,59,88,80,"True"
69,"[99]xmRdcLPDpNHogQJMqRwtfoctApchoIpBxdNQmEopebveHcpLhNieQbnNIwNNKHOnocSdMpJymMNApRvRBaRsMGzQSwvHMNJtNdD",3.50689e+20,0.973094,99,223,6,217,6,6,0,6,6,109,109,47,47,67,61,"True"
70,"[99]xmRdcLPDpNHogQJMqRwtfoctApchoIpBxdNQmEopebveHcpLhNieQbnNIwNNKHOnocSdMpJymMNApRvRBaRsMGzQSwvHMNJtNdD",5.47952e+20,0.977578,99,223,5,218,5,5,0,5,5,121,121,44,44,58,53,"True"
71,"[99]xmRdcLPDpNHogQJMqRwtfoctApchoIpBxdNQmEopebveHcpLhNieQbnNIwNNKHOnocSdMpJymMNApRvRBaRsMGzQSwvHMNJtNdD",4.04317e+18,0.944186,99,215,12,203,12,12,0,12,12,100,100,59,59,56,44,"True"
72,"[99]xmRdcLPDpNHogQJMqRwtfoctApchoIpBxdNQmEopebveHcpLhNieQbnNIwNNKHOnocSdMpJymMNApRvRBaRsMGzQSwvHMNJtNdD",3.80218e+22,0.960317,99,252,10,242,10,10,0,10,10,117,117,61,61,74,64,"True"
73,"[99]xmRdcLPDpNHogQJMqRwtfoctApchoIpBxdNQmEopebveHcpLhNieQbnNIwNNKHOnocSdMpJymMNApRvRBaRsMGzQSwvHMNJtNdD",3.50689e+20,0.964758,99,227,8,219,8,8,0,8,8,108,108,57,57,62,54,"True"
74,"[99]xmRdcLPDpNHogQJMqRwtfoctApchoIpBxdNQmEopebveHcpLhNieQbnNIwNNKHOnocSdMpJymMNApRvRBaRsMGzQSwvHMNJtNdD",7.49848e+25,0.96831,99,284,9,275,9,9,0,9,9,138,138,63,63,83,74,"True"
75,"[99]xmRdcLPDpNHogQJMqRwtfoctApchoIpBxdNQmEopebveHcpLhNieQbnNIwNNKHOnocSdMpJymMNApRvRBaRsMGzQSwvHMNJtNdD",3.50689e+20,0.964758,99,227,8,219,8,8,0,8,8,118,118,51,51,58,50,"True"
76,"[99]xmRdcLPDpNHogQJMqRwtfoctApchoIpBxdNQmEopebveHcpLhNieQbnNIwNNKHOnocSdMpJymMNApRvRBaRsMGzQSwvHMNJtNdD",3.80218e+22,0.960317,99,252,10,242,10,10,0,10,10,123,123,61,61,68,58,"True"
77,"[99]xmRdcLPDpNHogQJMqRwtfoctApchoIpBxdNQmEopebveHcpLhNieQbnNIwNNKHOnocSdMpJymMNApRvRBaRsMGzQSwvHMNJtNdD",2.4334e+22,0.971311,99,244,7,237,7,7,0,7,7,115,115,54,54,75,68,"True"
78,"[99]xmRdcLPDpNHogQJMqRwtfoctApchoIpBxdNQmEopebveHcpLhNieQbnNIwNNKHOnocSdMpJymMNApRvRBaRsMGzQSwvHMNJtNdD",2.61284e+21,0.958333,99,240,10,230,10,10,0,10,10,111,111,62,62,67,57,"True"
79,"[99]xmRdcLPDpNHogQJMqRwtfoctApchoIpBxdNQmEopebveHcpLhNieQbnNIwNNKHOnocSdMpJymMNApRvRBaRsMGzQSwvHMNJtNdD",2.24441e+20,0.96861,99,223,7,216,7,7,0,7,7,112,112,54,54,57,50,"True"
80,"[99]xmRdcLPDpNHogQJMqRwtfoctApchoIpBxdNQmEopebveHcpLhNieQbnNIwNNKHOnocSdMpJymMNApRvRBaRsMGzQSwvHMNJtNdD",1.45042e+23,0.957692,99,260,11,249,11,11,0,11,11,111,111,73,73,76,65,"True"
81,"[99]xmRdcLPDpNHogQJMqRwtfoctApchoIpBxdNQmEopebveHcpLhNieQbnNIwNNKHOnocSdMpJymMNApRvRBaRsMGzQSwvHMNJtNdD",7.35449e+19,0.963636,99,220,8,212,8,8,0,8,8,113,113,48,48,59,51,"True"
82,"[99]xmRdcLPDpNHogQJMqRwtfoctApchoIpBxdNQmEopebveHcpLhNieQbnNIwNNKHOnocSdMpJymMNApRvRBaRsMGzQSwvHMNJtNdD",1.32487e+18,0.97449,99,196,5,191,5,5,0,5,5,91,91,57,57,48,43,"True"
83,"[99]xmRdcLPDpNHogQJMqRwtfoctApchoIpBxdNQmEopebveHcpLhNieQbnNIwNNKHOnocSdMpJymMNApRvRBaRsMGzQSwvHMNJtNdD",1.45042e+23,0.96124,99,258,10,248,10,10,0,10,10,115,115,63,63,80,70,"True"
84,"[99]xmRdcLPDpNHogQJMqRwtfoctApchoIpBxdNQmEopebveHcpLhNieQbnNIwNNKHOnocSdMpJymMNApRvRBaRsMGzQSwvHMNJtNdD",3.80218e+22,0.967742,99,248,8,240,8,8,0,8,8,114,114,66,66,68,60,"True"
85,"[99]xmRdcLPDpNHogQJMqRwtfoctApchoIpBxdNQmEopebveHcpLhNieQbnNIwNNKHOnocSdMpJymMNApRvRBaRsMGzQSwvHMNJtNdD",3.50689e+20,0.964758,99,227,8,219,8,8,0,8,8,103,103,57,57,67,59,"True"
86,"[99]xmRdcLPDpNHogQJMqRwtfoctApchoIpBxdNQmEopebveHcpLhNieQbnNIwNNKHOnocSdMpJymMNApRvRBaRsMGzQSwvHMNJtNdD",9.87103e+18,0.980296,99,203,4,199,4,4,0,4,4,104,104,43,43,56,52,"True"
87,"[99]xmRdcLPDpNHogQJMqRwtfoctApchoIpBxdNQmEopebveHcpLhNieQbnNIwNNKHOnocSdMpJymMNApRvRBaRsMGzQSwvHMNJtNdD",3.7655e+19,0.971831,99,213,6,207,6,6,0,6,6,103,103,53,53,57,51,"True"
88,"[99]xmRdcLPDpNHogQJMqRwtfoctApchoIpBxdNQmEopebveHcpLhNieQbnNIwNNKHOnocSdMpJymMNApRvRBaRsMGzQSwvHMNJtNdD",1.79553e+20,0.977064,99,218,5,213,5,5,0,5,5,106,106,49,49,63,58,"True"
89,"[99]xmRdcLPDpNHogQJMqRwtfoctApchoIpBxdNQmEopebveHcpLhNieQbnNIwNNKHOnocSdMpJymMNApRvRBaRsMGzQSwvHMNJtNdD",5.42666e+17,0.969072,99,194,6,188,6,6,0,6,6,91,91,45,45,58,52,"True"
90,"[99]xmRdcLPDpNHogQJMqRwtfoctApchoIpBxdNQmEopebveHcpLhNieQbnNIwNNKHOnocSdMpJymMNApRvRBaRsMGzQSwvHMNJtNdD",7.35449e+19,0.963636,99,220,8,212,8,8,0,8,8,116,116,53,53,51,43,"True"
91,"[99]xmRdcLPDpNHogQJMqRwtfoctApchoIpBxdNQmEopebveHcpLhNieQbnNIwNNKHOnocSdMpJymMNApRvRBaRsMGzQSwvHMNJtNdD",1.07022e+21,0.935484,99,248,16,232,16,16,0,16,16,106,106,70,70,72,56,"True"
92,"[99]xmRdcLPDpNHogQJMqRwtfoctApchoIpBxdNQmEopebveHcpLhNieQbnNIwNNKHOnocSdMpJymMNApRvRBaRsMGzQSwvHMNJtNdD",6.31746e+18,0.970732,99,205,6,199,6,6,0,6,6,106,106,50,50,49,43,"True"
93,"[99]xmRdcLPDpNHogQJMqRwtfoctApchoIpBxdNQmEopebveHcpLhNieQbnNIwNNKHOnocSdMpJymMNApRvRBaRsMGzQSwvHMNJtNdD",3.1013e+28,0.977199,99,307,7,300,7,7,0,7,7,149,149,65,65,93,86,"True"
94,"[99]xmRdcLPDpNHogQJMqRwtfoctApchoIpBxdNQmEopebveHcpLhNieQbnNIwNNKHOnocSdMpJymMNApRvRBaRsMGzQSwvHMNJtNdD",6.31746e+18,0.9801,99,201,4,197,4,4,0,4,4,98,98,51,51,52,48,"True"
95,"[99]xmRdcLPDpNHogQJMqRwtfoctApchoIpBxdNQmEopebveHcpLhNieQbnNIwNNKHOnocSdMpJymMNApRvRBaRsMGzQSwvHMNJtNdD",2.4334e+22,0.96371,99,248,9,239,9,9,0,9,9,118,118,65,65,65,56,"True"
96,"[99]xmRdcLPDpNHogQJMqRwtfoctApchoIpBxdNQmEopebveHcpLhNieQbnNIwNNKHOnocSdMpJymMNApRvRBaRsMGzQSwvHMNJtNdD",1.43642e+20,0.976959,99,217,5,212,5,5,0,5,5,105,105,62,62,50,45,"True"
97,"[99]xmRdcLPDpNHogQJMqRwtfoctApchoIpBxdNQmEopebveHcpLhNieQbnNIwNNKHOnocSdMpJymMNApRvRBaRsMGzQSwvHMNJtNdD",4.70687e+19,0.963303,99,218,8,210,8,8,0,8,8,109,109,50,50,59,51,"True"
98,"[99]xmRdcLPDpNHogQJMqRwtfoctApchoIpBxdNQmEopebveHcpLhNieQbnNIwNNKHOnocSdMpJymMNApRvRBaRsMGzQSwvHMNJtNdD",1.43642e+20,0.940426,99,235,14,221,14,14,0,14,14,116,116,54,54,65,51,"True"
99,"[99]xmRdcLPDpNHogQJMqRwtfoctApchoIpBxdNQmEopebveHcpLhNieQbnNIwNNKHOnocSdMpJymMNApRvRBaRsMGzQSwvHMNJtNdD",7.35449e+19,0.981132,99,212,4,208,4,4,0,4,4,104,104,43,43,65,61,"True"
